{
    "tiles": [
        [2,3,2,2,3,2,0,3,2,3,2,2,3,3,0,2],
        [0,0,0,0,0,0,0,0,0,0,0,0,0,0,0,0],
        [0,0,0,0,0,0,0,0,0,0,0,1,0,0,0,0],
        [0,0,0,0,0,0,0,0,0,0,0,0,0,0,0,0],
        [0,0,0,0,0,0,0,0,0,0,0,0,0,0,0,0],
        [0,0,0,0,0,0,0,0,0,0,0,0,0,0,0,0],
        [0,0,0,2,2,3,2,3,2,2,0,3,2,0,0,0],
        [2,3,2,0,3,3,2,3,2,3,2,2,0,3,2,2]
    ],
    "enemyPoints": [
        { "x": [40, 120], "y": [80, 200] },
        { "x": [280, 360], "y": [80, 200] },
        { "x": [480, 520], "y": [80, 200] }
    ],
    "itemPoints": [
        { "x": [180, 240], "y": [80, 200] },
        { "x": [380, 440], "y": [80, 200] }
    ]
}