{
    "tiles": [
        [0,0,0,3,2,3,0,2,3,2,1,2,3,3,0,0],
        [0,0,0,0,0,0,0,2,2,3,0,0,0,0,0,0],
        [0,0,0,0,0,0,0,3,0,2,0,0,0,0,0,0],
        [0,0,0,0,0,0,0,2,3,2,0,0,0,0,0,0],
        [0,0,0,0,0,0,0,3,2,3,0,0,0,0,0,0],
        [0,0,0,0,0,0,0,0,0,0,0,0,0,0,0,0],
        [0,0,0,0,0,0,0,0,0,0,0,0,0,0,0,0],
        [0,0,0,0,0,0,0,0,0,0,0,0,0,0,0,0]
    ],
    "enemyPoints": [
        { "x": [40, 360], "y": [240, 280] },
        { "x": [440, 480], "y": [80, 280] }
    ],
    "itemPoints": [
        { "x": [40, 200], "y": [80, 280] }
    ]
}