{
    "tiles": [
        [0,0,0,0,0,0,0,0,0,0,0,0,0,2,3,2],
        [0,0,0,0,0,0,0,0,0,0,0,0,0,0,0,0],
        [0,0,0,0,0,0,0,0,0,0,0,0,0,0,0,0],
        [0,0,0,0,0,0,0,0,0,0,0,0,0,0,0,0],
        [0,0,0,0,0,0,3,2,0,0,0,0,0,0,0,0],
        [0,0,0,0,0,3,3,2,3,0,0,0,0,0,0,0],
        [0,0,0,0,2,2,2,3,2,2,0,0,0,0,0,0],
        [3,2,3,2,3,2,3,3,2,3,2,2,0,2,3,2]
    ],
    "enemyPoints": [
        { "x": [40, 120], "y": [40, 160] },
        { "x": [440, 520], "y": [80, 240] }
    ],
    "itemPoints": [
        { "x": [440, 500], "y": [80, 240] }
    ]
}