{
    "tiles": [
        [0,0,0,0,0,0,0,0,0,1,0,0,0,0,0,0],
        [0,0,0,0,0,0,0,0,0,0,0,0,0,0,0,0],
        [0,0,0,0,0,0,0,0,0,0,0,0,0,0,0,0],
        [2,2,0,0,0,0,0,2,3,0,0,0,0,0,2,3],
        [3,2,0,0,0,0,0,2,2,0,0,0,0,0,2,2],
        [0,0,0,0,0,0,0,0,0,0,0,0,0,0,0,0],
        [0,0,0,0,0,0,0,0,0,0,0,0,0,0,0,0],
        [0,0,0,0,0,0,0,0,0,0,0,0,0,0,0,0]
    ],
    "enemyPoints": [
        { "x": [120, 160], "y": [40, 280] },
        { "x": [400, 440], "y": [40, 280] }
    ],
    "itemPoints": [
        { "x": [380, 380], "y": [60, 80] },
        { "x": [380, 380], "y": [240, 280] }
    ]
}