{
    "tiles": [
        [0,0,0,0,0,0,0,0,0,0,0,0,0,0,0,0],
        [0,0,0,0,0,0,0,0,0,0,0,0,0,0,0,0],
        [0,0,0,0,0,0,0,0,0,0,0,0,0,0,0,0],
        [0,0,0,0,0,0,0,0,0,0,0,0,0,0,0,2],
        [0,0,0,0,0,0,3,0,0,0,0,0,0,0,0,3],
        [0,0,2,0,0,2,2,0,0,0,0,3,0,0,0,2],
        [0,0,3,0,0,2,3,3,2,0,3,2,0,3,2,3],
        [2,3,2,3,2,3,2,2,2,3,2,3,2,2,3,2]
    ],
    "enemyPoints": [
        { "x": [80, 160], "y": [40, 120] },
        { "x": [240, 360], "y": [40, 180] } 
    ],
    "itemPoints": [
        { "x": [480, 540], "y": [180, 180] }
    ]
}