{
    "tiles": [
        [2,3,2,2,3,2,3,2,3,2,0,2,1,3,3,2],
        [0,0,0,0,0,0,0,0,0,0,0,0,0,2,0,0],
        [0,0,0,0,0,0,0,0,0,0,0,0,0,3,0,0],
        [0,0,0,0,0,0,0,0,0,0,0,0,0,0,0,0],
        [0,0,0,0,0,3,2,3,2,0,0,0,0,0,0,0],
        [0,0,0,0,3,2,0,0,3,0,0,0,0,0,0,0],
        [0,0,0,0,2,2,3,0,2,0,0,0,0,0,0,0],
        [3,2,3,3,2,3,2,2,2,3,2,3,2,2,3,2]
    ],
    "enemyPoints": [
        { "x": [200, 300], "y": [80, 120] },
        { "x": [400, 520], "y": [160, 240] }
    ],
    "itemPoints": [
        { "x": [400, 520], "y": [160, 240] }
    ]
}