{
    "tiles": [
        [2,3,2,2,0,0,0,0,0,0,0,0,0,0,0,0],
        [0,0,3,2,0,0,0,0,0,0,0,0,0,0,0,0],
        [0,0,0,0,0,0,0,0,0,0,0,0,0,0,0,0],
        [0,0,0,0,0,0,0,0,0,0,3,3,3,2,2,3],
        [0,0,0,0,0,0,0,0,0,0,3,2,2,3,3,2],
        [0,0,0,0,0,0,0,0,0,0,0,0,0,0,0,0],
        [0,0,0,2,0,0,0,0,0,0,0,0,0,0,0,0],
        [0,3,2,3,0,0,0,0,0,0,0,0,0,0,0,0]
    ],
    "enemyPoints": [
        { "x": [40, 200], "y": [120, 200] },
        { "x": [440, 520], "y": [40, 120] },
        { "x": [440, 520], "y": [240, 280] }
    ],
    "itemPoints": [
        { "x": [200, 360], "y": [40, 280] }
    ]
}