{
    "tiles": [
        [2,3,2,2,2,3,3,2,3,0,2,3,2,3,2,3],
        [5,0,0,0,0,0,0,0,0,0,0,0,0,0,0,0],
        [5,0,0,0,0,0,0,0,0,0,0,0,0,0,0,0],
        [5,0,0,0,0,0,0,0,0,0,0,0,0,0,0,0],
        [5,0,0,0,0,0,0,0,0,0,0,0,0,0,0,0],
        [5,0,0,0,0,0,0,0,0,0,0,0,3,3,2,3],
        [5,0,0,0,0,0,0,0,0,0,2,3,2,2,3,2],
        [2,3,2,3,3,2,2,3,2,2,0,3,2,3,2,3]
    ],
    "enemyPoints": [
        { "x": [280, 520], "y": [80, 160] }
    ],
    "itemPoints": [
        { "x": [80, 320], "y": [80, 200] }
    ]
}