{
    "tiles": [
        [0,2,3,3,2,3,0,3,2,3,2,2,3,0,2,2],
        [0,0,3,0,0,3,2,0,0,0,0,0,0,0,2,3],
        [0,0,2,0,0,2,0,0,0,0,0,0,0,0,0,2],
        [0,0,0,0,0,0,0,0,0,0,0,0,0,0,0,3],
        [0,0,0,0,0,0,0,0,0,0,0,0,0,0,0,0],
        [0,0,0,0,0,0,0,0,0,3,0,0,0,0,0,0],
        [0,0,0,0,0,0,0,0,0,2,0,0,0,0,0,0],
        [3,2,3,0,0,0,0,0,0,3,2,3,2,3,2,2]
    ],
    "enemyPoints": [
        { "x": [40, 200], "y": [160, 240] },
        { "x": [420, 460], "y": [120, 240] }
    ],
    "itemPoints": [
        { "x": [160, 280], "y": [180, 280] }
    ]
}