{
    "tileDataFile": "eurth_tiles.json",
    "tiles": [
        [2,3,2,0,1,0,0,3,2,2],
        [0,0,0,0,0,0,0,0,2,3],
        [0,0,0,0,0,0,0,0,0,4],
        [0,0,0,0,0,0,0,0,0,4],
        [0,0,0,0,0,0,0,0,0,4],
        [0,0,0,0,0,0,0,0,0,4],
        [0,0,0,0,0,0,0,0,3,2],
        [3,2,0,3,2,0,0,3,2,3]
    ]
}