{
    "tileDataFile": "space_tiles.json",
    "tiles": [
        [0,0,0,0,0,0,0,0,0,0,0,0,0,0,0,0,0],
        [0,0,0,0,0,4,0,0,0,0,0,0,0,0,0,0,0],
        [0,0,0,0,0,0,0,0,0,0,0,0,0,0,0,0,0],
        [0,0,0,0,0,0,0,0,0,0,0,0,0,0,0,0,0],
        [0,0,0,0,0,0,0,0,0,0,0,0,0,0,0,0,0],
        [0,0,0,0,0,0,0,0,0,3,0,0,0,0,0,0,0],
        [0,0,0,0,0,0,0,0,0,0,0,0,0,0,0,0,0],
        [9,9,9,9,9,9,9,9,9,9,9,9,9,9,9,9,9]
    ],
    "enemies": [
        { "t": "Boss", "x": 545, "y": 145 }
    ],
    "name": "Showdown"
}