{
    "tileDataFile": "eurth_tiles.json",
    "tiles": [
        [2,3,2,3,3,2,3,2,2,3,2,2,2,3,3,3,2,3,0,3,2,3,2,3,3,2,3,2,2,3,2,2,2,3,3,3,2,3,2,3,3,2,3,3,2,3,2,2,3,2,2,3,2,3,3,2,3,2,2,3,2,2,2,3,3,3,2,3,2,3,3,2,3,3,2,3,2,2,3,2,2,3,2,3,3,2,3,2,0,0,0,0,0,0,0,0,0,0,0,0,0,0,0,0,0,0,0,0,0,0,0,0,3,3,0,2,2,3,0,2,3,2,3,2,2,3,2,3,3,2,2,2,3,2,3,2,2,2,0,2,3,2,2,0,3,2,3,3,2,2,2,3,2,3,2,2,2,0,2,3,2,2,1,2,3,2,3,3,3,2,3,0,3,2,3,2,3,3,2,3],
        [0,0,0,0,0,0,0,5,0,0,0,0,0,0,0,0,0,0,0,0,0,0,0,0,1,0,0,0,0,0,0,0,0,0,0,0,0,0,0,0,0,0,0,0,0,0,0,0,0,0,0,0,0,0,0,0,0,0,0,0,0,0,0,0,0,0,0,0,0,0,0,0,0,0,0,0,0,0,0,0,0,0,0,0,0,0,0,0,0,0,0,1,0,0,0,0,0,0,0,0,0,0,0,0,0,0,0,0,0,0,0,0,2,3,2,3,2,2,3,2,3,0,2,3,2,3,2,0,3,3,0,2,2,3,0,2,3,2,3,2,2,3,2,3,3,2,3,2,2,3,2,3,0,2,3,2,3,2,0,3,3,0,2,2,3,0,0,0,0,1,0,0,0,0,0,0,0,0,0,4],
        [0,0,0,0,0,0,0,5,0,0,0,0,0,0,0,0,0,0,0,0,0,0,0,0,0,0,0,0,0,0,0,0,0,0,0,0,0,0,0,0,0,0,0,0,0,0,0,0,0,0,0,0,0,0,0,0,0,0,0,0,0,0,0,0,0,0,0,0,0,0,0,0,0,0,0,0,0,0,0,0,0,0,0,0,0,0,0,0,0,0,0,0,0,0,0,0,0,0,0,0,0,0,0,0,0,0,0,0,0,0,0,0,0,0,0,0,0,0,0,0,0,0,0,0,0,0,0,0,0,0,0,0,0,0,0,0,0,0,0,0,0,0,0,0,0,0,0,0,0,0,0,0,0,0,0,0,0,0,0,0,0,0,0,0,0,0,0,0,0,0,0,0,0,0,0,0,0,0,0,4],
        [0,0,0,0,0,0,0,5,0,0,0,0,0,0,0,0,0,0,0,0,0,0,0,0,0,0,0,0,0,0,0,0,0,0,0,0,0,0,0,0,0,0,0,0,0,0,0,0,0,0,0,0,0,0,0,0,0,0,0,0,0,0,0,0,0,0,0,0,0,0,0,0,0,0,0,0,0,0,0,0,0,0,0,0,0,0,0,0,0,0,0,2,3,3,2,2,2,3,2,3,2,2,2,0,2,3,2,2,0,0,0,0,0,0,0,0,0,0,0,0,0,0,0,0,0,0,0,0,0,0,0,0,0,0,0,0,0,0,0,0,0,0,0,0,0,0,0,0,0,0,0,0,0,0,0,0,0,0,0,0,0,0,0,0,0,0,0,0,0,0,0,0,0,0,0,0,0,0,0,4],
        [0,0,0,0,0,0,0,5,0,0,0,0,0,0,0,0,0,0,0,0,0,0,0,0,0,0,0,0,0,0,0,0,0,0,0,0,0,0,0,0,0,0,0,0,0,0,0,0,0,0,0,0,0,0,0,0,0,0,0,0,0,0,0,0,0,0,0,0,0,0,0,0,0,0,0,0,0,0,0,0,0,0,0,0,0,0,0,0,0,0,0,3,0,2,2,3,3,2,2,0,3,2,2,2,2,3,2,3,0,0,0,0,0,0,0,0,0,0,0,0,0,0,0,0,0,0,0,0,0,0,0,0,0,0,0,0,0,0,0,0,0,0,0,0,0,0,0,0,0,0,0,0,0,0,0,0,0,0,0,0,0,0,0,0,0,0,0,0,0,0,0,0,0,0,0,0,0,0,0,4],
        [0,0,0,0,0,0,0,5,0,0,0,0,0,0,0,0,0,0,0,0,0,0,0,0,0,0,0,0,0,0,0,0,0,0,0,0,0,0,0,0,0,0,0,0,0,0,0,0,0,0,0,0,0,0,0,0,0,0,0,0,0,0,0,0,0,0,0,0,0,0,0,0,0,0,0,0,0,0,0,0,0,0,0,0,0,0,0,0,0,0,0,0,0,0,0,0,0,0,0,0,0,0,0,0,0,0,0,0,0,0,0,0,0,0,0,2,0,0,3,2,0,0,0,2,3,0,3,0,0,0,0,0,0,0,0,0,0,0,0,0,0,0,0,0,0,0,0,0,0,0,0,0,0,0,0,0,0,0,0,0,0,0,0,0,0,0,0,0,0,0,0,0,0,0,0,0,0,0,0,4],
        [0,0,0,0,0,0,0,5,0,1,0,0,0,0,0,0,0,0,0,0,0,0,0,0,0,0,0,0,0,0,0,0,0,0,0,0,0,0,0,0,0,0,0,0,0,0,0,0,0,0,0,0,0,0,0,0,0,0,0,0,0,0,0,0,0,0,0,0,0,0,0,0,0,0,0,0,0,0,0,0,0,0,0,0,0,0,0,0,0,0,0,0,0,0,0,0,0,0,0,0,0,0,0,0,0,0,0,0,0,0,0,0,2,2,3,2,2,2,3,2,0,2,3,2,3,2,3,3,3,2,3,3,2,3,3,2,3,2,2,3,2,2,2,3,0,2,2,3,2,2,2,3,2,0,2,3,2,3,2,3,3,3,0,0,0,0,0,0,0,0,0,0,0,0,0,0,0,0,0,4],
        [2,3,2,2,3,2,3,3,3,2,3,2,0,3,2,3,2,2,3,2,2,3,2,3,3,2,3,2,2,3,2,2,2,3,3,3,2,3,2,3,3,2,3,3,2,3,2,2,3,2,2,2,3,3,3,2,3,0,3,2,3,2,2,3,2,3,3,2,3,2,2,3,2,2,2,3,3,3,2,3,0,3,2,3,2,3,0,2,0,0,0,0,0,0,0,0,0,0,0,0,0,0,0,0,1,0,0,0,0,0,0,2,2,3,2,0,2,3,3,2,3,2,2,2,3,2,3,3,3,2,2,3,2,2,2,3,3,3,2,3,0,3,2,3,3,2,2,3,2,2,2,3,0,2,2,3,2,2,2,3,2,2,3,0,3,2,2,3,2,3,3,3,2,3,2,0,3,2,3,2]
    ],
    "enemies": [
        { "t": "Philbert", "x": 900, "y": 240 },
        { "t": "Philbert", "x": 980, "y": 100 },
        { "t": "Philbert", "x": 1060, "y": 160 },
        { "t": "Philbert", "x": 1140, "y": 240 },
        { "t": "Philbert", "x": 1220, "y": 120 },
        { "t": "Clinger", "x": 1600, "y": 60 },
        { "t": "Clinger", "x": 1600, "y": 260 },
        { "t": "VectorToad", "x": 2400, "y": 80 },
        { "t": "VectorToad", "x": 3000, "y": 240 },
        { "t": "Stretcher", "x": 3400, "y": 120 },
        { "t": "Stretcher", "x": 3500, "y": 180 },
        { "t": "Stretcher", "x": 3600, "y": 60 },
        { "t": "Stretcher", "x": 3700, "y": 60 },
        { "t": "Stretcher", "x": 3800, "y": 220 },
        { "t": "Stretcher", "x": 3900, "y": 260 },
        { "t": "Stretcher", "x": 4000, "y": 40 },
        { "t": "Stretcher", "x": 4100, "y": 100 },
        { "t": "Stretcher", "x": 4200, "y": 200 },
        { "t": "Stretcher", "x": 4300, "y": 100 },
        { "t": "Stretcher", "x": 4400, "y": 100 },
        { "t": "Domesworth", "x": 4880, "y": 100 },
        { "t": "Domesworth", "x": 4960, "y": 100 },
        { "t": "Domesworth", "x": 5040, "y": 100 },
        { "t": "Domesworth", "x": 5120, "y": 100 },
        { "t": "Domesworth", "x": 5200, "y": 180 },
        { "t": "VectorToad", "x": 5800, "y": 180 },
        { "t": "VectorToad", "x": 6000, "y": 180 },
        { "t": "Clinger", "x": 7000, "y": 120 },
        { "t": "Clinger", "x": 7000, "y": 180 },
        { "t": "Domesworth", "x": 6900, "y": 80 },
        { "t": "Domesworth", "x": 6980, "y": 80 },
        { "t": "Domesworth", "x": 7060, "y": 80 },
        { "t": "VectorToad", "x": 7100, "y": 80 },
        { "t": "Barrier", "x": 7180, "y": -1 }
    ],
    "items": [
        { "t": "CoinG", "x": 940, "y": 190 },
        { "t": "CoinG", "x": 1060, "y": 240 },
        { "t": "SpeedBoost", "x": 1200, "y": 80 },
        { "t": "SpeedBoost", "x": 1500, "y": 200 },
        { "t": "CoinY", "x": 3580, "y": 160 },
        { "t": "SpeedBoost", "x": 4100, "y": 280 },
        { "t": "BombRefill", "x": 4200, "y": 40 },
        { "t": "CoinR", "x": 4500, "y": 160 },
        { "t": "CoinR", "x": 4560, "y": 160 }
    ],
    "name": "Eurth 2"
}