{
    "tileDataFile": "space_tiles.json",
    "tiles": [
        [8,8,8,8,8,8,8,8,8,8,8,8,8,8,8,8,8,8,8,8,8,8,8,8,8,8,8,8,8,8,8,8,8,8,8,8,8,8,8,8,8,8,8,8,8,8,8,8,8,8,8,8,8,8,8,8,8,8,8,8,8,8,8,8,8,8,8,8,8,8,8,8,8,8,8,8,8,8,8,8,8,8,8,8,8,8,8,8,8,8,8,8,8,8,8,8,8,8,8,8,8,8,8,8,8,8,8,8,8,8,8,8,8,8,8,8,8,8,8,8,8,8,8,8,8,6],
        [0,0,0,0,0,0,0,0,0,0,0,0,0,0,0,0,0,0,0,0,0,0,0,0,0,0,0,0,0,0,0,0,0,0,4,0,0,0,0,0,0,0,0,0,0,0,0,0,0,0,0,0,0,0,0,0,0,0,0,0,0,0,0,0,0,0,0,0,0,0,0,9,0,0,0,9,0,0,0,9,9,9,9,0,0,0,9,9,9,9,0,0,0,0,0,0,0,0,0,0,0,0,0,0,0,0,0,0,0,0,0,0,0,0,0,0,0,0,0,0,0,0,0,0,0,6],
        [0,0,0,0,0,0,0,0,0,0,0,0,0,0,0,0,3,0,0,0,0,0,0,0,0,0,0,0,0,0,0,0,0,0,0,0,0,0,0,0,0,0,0,0,0,0,0,0,0,0,0,0,0,0,0,0,0,0,0,0,0,0,0,0,0,0,0,0,0,0,0,9,0,0,0,9,0,0,0,0,0,0,0,0,0,0,0,0,0,0,0,0,0,0,0,0,0,0,0,0,0,0,0,0,0,0,0,0,0,0,0,0,0,0,0,0,0,0,0,0,0,0,0,0,0,6],
        [0,0,0,0,0,0,0,0,0,0,0,0,0,0,0,0,0,0,0,0,0,4,0,0,0,0,0,0,0,0,0,0,0,0,0,0,0,0,0,0,0,0,0,0,0,0,0,0,0,0,0,0,0,0,0,0,0,0,0,0,0,0,0,0,0,0,0,0,0,3,0,0,0,0,0,0,0,0,0,0,0,0,0,0,0,0,0,0,0,0,0,0,0,0,0,0,0,0,0,0,0,0,0,0,0,0,0,0,0,0,0,0,0,0,0,0,0,0,0,0,0,0,0,0,0,6],
        [0,0,0,0,0,0,0,0,0,0,0,0,0,0,0,0,9,9,9,9,0,0,0,0,0,0,0,0,0,0,0,0,0,0,0,0,0,0,0,0,0,0,0,0,0,0,0,0,0,0,3,0,0,0,0,0,0,0,0,0,0,0,0,0,0,0,0,0,0,0,0,0,0,0,0,0,0,0,0,0,0,0,0,0,0,0,0,0,0,0,0,0,0,0,0,0,0,0,0,0,0,0,0,0,0,0,0,0,0,0,0,0,0,0,0,0,0,0,0,0,0,0,0,0,0,6],
        [0,0,0,0,0,0,0,0,0,0,0,0,0,0,0,0,0,0,0,0,0,0,0,0,0,0,0,0,0,0,0,0,0,0,5,0,0,0,0,0,0,0,0,0,0,0,0,0,0,0,0,0,0,0,0,0,0,0,0,0,0,0,0,0,0,0,0,0,0,0,0,0,0,0,0,0,0,0,0,0,0,0,0,0,0,0,0,0,0,0,0,0,0,0,0,0,0,0,0,0,0,0,0,0,0,0,0,0,0,0,0,0,0,5,0,0,0,0,0,0,0,0,0,0,0,6],
        [0,0,0,0,0,0,0,0,0,0,0,0,0,0,0,0,0,0,0,0,0,0,0,0,0,0,0,0,0,0,0,0,0,0,0,0,0,3,0,0,0,0,0,0,0,0,0,0,0,0,0,0,0,0,0,0,0,0,0,0,0,0,0,0,0,0,9,9,9,9,0,0,0,0,0,9,9,9,9,9,9,9,9,0,0,0,9,9,9,9,0,0,0,0,0,0,0,0,0,4,0,0,0,0,0,0,0,0,4,0,0,0,0,0,0,0,0,0,0,0,0,0,0,0,0,6],
        [7,7,7,7,7,7,7,7,7,7,7,7,7,7,7,7,7,7,7,7,7,7,7,7,7,7,7,7,7,7,7,7,7,7,7,7,7,7,7,7,7,7,7,7,7,7,7,7,7,7,7,7,7,7,7,7,7,7,7,7,7,7,7,7,7,7,7,7,7,7,7,7,7,7,7,7,7,7,7,7,7,7,7,7,7,7,7,7,7,7,7,7,7,7,7,7,7,7,7,7,7,7,7,7,7,7,7,7,7,7,7,7,7,7,7,7,7,7,7,7,7,7,7,7,7,6]
    ],
    "enemies": [
        { "t": "Lava", "x": 1600, "y": -1 },
        { "t": "Lava", "x": 1880, "y": 1 },
        { "t": "Lava", "x": 2160, "y": -1 },
        { "t": "Lava", "x": 2940, "y": 1 },
        { "t": "Lava", "x": 3380, "y": -1 },
        { "t": "Lava", "x": 3660, "y": 1 },
        { "t": "Domesworth", "x": 660, "y": 60 },
        { "t": "Domesworth", "x": 720, "y": 60 },
        { "t": "Domesworth", "x": 780, "y": 60 },
        { "t": "VectorToad", "x": 1420, "y": 80 },
        { "t": "VectorToad", "x": 1500, "y": 200 },
        { "t": "Domesworth", "x": 2660, "y": 40 },
        { "t": "Domesworth", "x": 2720, "y": 40 },
        { "t": "Domesworth", "x": 2780, "y": 40 },
        { "t": "Stretcher", "x": 3220, "y": 120 },
        { "t": "Stretcher", "x": 3300, "y": 200 },
        { "t": "Stretcher", "x": 3460, "y": 120 },
        { "t": "Stretcher", "x": 3540, "y": 200 },
        { "t": "VectorToad", "x": 4460, "y": 80 },
        { "t": "VectorToad", "x": 4580, "y": 240 },
        { "t": "VectorToad", "x": 4700, "y": 160 },
        { "t": "VectorToad", "x": 4820, "y": 80 },
        { "t": "VectorToad", "x": 4980, "y": 240 }
    ],
    "items": [
        { "t": "ShotSwap", "x": 700, "y": 240 },
        { "t": "SpeedBoost", "x": 980, "y": 80 },
        { "t": "CoinG", "x": 1720, "y": 80 },
        { "t": "CoinG", "x": 1720, "y": 160 },
        { "t": "CoinG", "x": 1720, "y": 240 },
        { "t": "CoinG", "x": 1820, "y": 80 },
        { "t": "CoinR", "x": 1820, "y": 160 },
        { "t": "CoinG", "x": 1820, "y": 240 },
        { "t": "CoinG", "x": 1920, "y": 80 },
        { "t": "CoinR", "x": 1920, "y": 160 },
        { "t": "CoinG", "x": 1920, "y": 240 },
        { "t": "CoinG", "x": 2020, "y": 80 },
        { "t": "CoinG", "x": 2020, "y": 160 },
        { "t": "CoinG", "x": 2020, "y": 240 },
        { "t": "SpeedBoost", "x": 2340, "y": 100 },
        { "t": "CoinY", "x": 2940, "y": 100 }
    ],
    "name": "Hot Zone"
}